
die down - 가라앉다
do away with - 폐지하다/없애다
do up - 장식하다
doze off - 깜빡 잠들다
drag on - 질질 끌다
draw out - 길게 끌다
dress down - 호되게 꾸짖다
drop off - 전달하다, 내려주다
duck out - 슬그머니 빠져나가다
ease off - 완화되다
edge out - 간신히 이기다
end up - 결국 ~하게 되다
face up to - 직시하다
fall for - 속다, 사랑에 빠지다
fend off - 막아내다

fizzle out - 흐지부지 끝나다
flare up - 확 타오르다, 악화되다
freak out - 기겁하다

get ahead - 성공하다
get along - 잘 지내다
get at - 의미하다
get by - 그럭저럭 살아가다
get over - 극복하다
give in - 굴복하다
go about - 처리하다

go for - 선택하다
go under - 파산하다
grow on - 점점 좋아지다
hang around - 어슬렁거리다
hang in - 버티다
hang out - 어울리다
head off - 막다
hear out - 끝까지 듣다
hit it off - 죽이 잘 맞다
hold off - 미루다
hold over - 연기하다
hunker down - 단단히 준비하다
keep at - 포기하지 않고 계속하다

kick around - 논의하다
knock off - 그만두다
lash out - 마구 화를 내다
lay into - 거칠게 비난하다
lead up to - 결국 ~에 이르다
leave off - 그만두다
let on - 누설하다
let up - 약해지다
lighten up - 기분을 풀다
live down - 잊히게 하다
lock in - 확정하다
log off - 로그아웃하다
look into - 조사하다
make for - 향하다
make out - 해내다, 알아보다
mess up - 망치다
