


peevish - 짜증을 잘 내는
penchant - 강한 기호, 애호
pensive - 수심에 잠긴, 깊은 생각에 잠긴
peril - 위험
perish - 죽다, 소멸하다
permeate - 스며들다
perplex - 혼란스럽게 하다
persevere - 인내하며 계속하다
pertinent - 적절한
petty - 사소한
philanthropy - 자선 활동
pinnacle - 정점
pious - 경건한
pique - (감정을) 자극하다, 화나게 하다
placate - 달래다
plagiarize - 표절하다
plausible - 그럴듯한
plethora - 과잉, 지나침
plight - 역경, 고난
plummet - 곤두박질치다
plunder - 약탈하다
poignant - 가슴 아픈, 감동적인
polarize - 양극화하다
pompous - 거만한, 잘난 체하는
ponder - 곰곰이 생각하다
posterity - 후세
potent - 강력한
pragmatic - 실용적인

predicament - 곤경
preposterous - 말도 안 되는
presume - 추정하다
prevalent - 일반적인, 널리 퍼진
pristine - 원래 그대로의, 아주 깨끗한
probity - 정직성
procrastinate - 미루다
prodigal - 낭비하는
prodigious - 엄청난
profane - 불경스러운
proficient - 능숙한
promulgate - 공표하다
prone - ~하기 쉬운
propagate - 퍼뜨리다
propel - 나아가게 하다
propensity - 경향
prosaic - 평범한, 지루한
prosper - 번영하다
prudent - 신중한
pugnacious - 싸우기 좋아하는
punctual - 시간을 잘 지키는
pungent - 톡 쏘는, 자극적인
quaint - 예스러운 매력이 있는
quell - 진압하다
quench - (갈증 등을) 해소하다
query - 질문, 의문
quibble - 트집 잡다
quirk - 기이한 버릇
rampant - 만연한
rancid - 악취나는
rant - 고함치다, 열변을 토하다
rapport - 친밀한 관계
rash - 성급한
ratify - 비준하다
raucous - 시끄러운
recede - 물러나다
reconcile - 화해하다
rectify - 바로잡다
rejuvenate - 활력을 되찾게 하다
relent - 누그러지다
relish - 즐기다
remorse - 후회
renounce - 포기하다
reprehensible - 비난받을 만한
reprieve - 유예, 집행 연기
reprimand - 질책하다
reprisal - 보복
reproach - 꾸짖다
