dazzle - 눈부시게 하다, 현혹하다
deceit - 속임수, 기만
decree - 포고하다, 법령
deference - 존경, 경의
defiant - 반항적인, 도전적인
deft - 능숙한, 솜씨 좋은
deliberate - 의도적인, 신중한
delirious - 정신없는, 열광적인
delve - 파헤치다, 조사하다
demeanor - 태도, 행동양식
demise - 죽음, 종료
denounce - 비난하다, 고발하다
depict - 묘사하다, 그리다
desolate - 황폐한, 쓸쓸한
despicable - 비열한, 경멸할 만한
deteriorate - 악화되다, 나빠지다
detest - 혐오하다, 싫어하다
devious - 교활한, 우회하는
disarray - 무질서, 혼란
discern - 식별하다, 알아보다
discreet - 신중한, 조심스러운
disposition - 성격, 배치
dote - 맹목적으로 사랑하다
downcast - 의기소침한, 우울한
drab - 칙칙한, 단조로운
drench - 흠뻑 적시다
drowsy - 졸린, 나른한
dull - 둔한, 지루한
dwindle - 줄어들다, 감소하다
makeup                                                      구조
makeup                                                      구조
makeup                                                      구조
makeup                                                      구조
makeup                                                      구조
makeup                                                      구조
makeup                                                      구조
makeup                                                      구조
makeup                                                      구조
makeup                                                      구조
makeup                                                      구조
makeup                                                      구조
makeup                                                      구조
makeup                                                      구조
makeup                                                      구조
