







confirm: 확인하다

conform: 따르다

confront: 직면하다

conserve: 보존하다

consist: ~로 구성되다

constitute: 구성하다 (이미 제시된 constitute와 중복. '구성하다'의 다른 뉘앙스)

construct: 건설하다

consult: 상담하다

consume: 소비하다

contemplate: 심사숙고하다

contend: 주장하다, 다투다

contract: 계약하다, 수축하다

contradict: 반박하다

contribute: 기여하다

convey: 전달하다

convict: 유죄를 선고하다

coordinate: 조정하다

cope: 대처하다

correlate: 연관시키다

counter: 반박하다, 대응하다

cultivate: 경작하다, 함양하다

decline: 감소하다, 거절하다

deduce: 추론하다

defy: 저항하다

delegate: 위임하다

deliberate: 심사숙고하다

demonstrate: 시연하다, 증명하다

depict: 묘사하다

derive: 얻다, 유래하다

designate: 지정하다

detect: 감지하다

deter: 단념시키다

devise: 고안하다

devote: 헌신하다

differentiate: 구별하다

diminish: 줄이다

disclose: 폭로하다

discount: 할인하다, 무시하다
로 만들다

dwell: 살다, 깊이 생각하다

elevate: 높이다

elicit: 이끌어내다

embark: 착수하다

embrace: 포옹하다, 받아들이다

emerge: 나타나다

emphasize: 강조하다

enable: 가능하게 하다 (이미 제시된 enable은 '활성화시키다'의 의미로 사용되었으니 다른 의미의 '가능하게 하다'로 사용합니다)

enclose: 에워싸다

encounter: 마주치다

endorse: 지지하다

enhance: 향상시키다

ensure: 보장하다

entail: 수반하다

envision: 상상하다

equip: 갖추다


exhaust: 소진하다, 지치게 하다

expedite: 신속히 처리하다

exploit: 이용하다, 착취하다

facilitate: 용이하게 하다

falter: 흔들리다

foresee: 예견하다

forfeit: 몰수당하다

formulate: 공식화하다

foster: 육성하다

furnish: 제공하다


ignite: 불을 붙이다

illustrate: 설명하다, 삽화를 그리다

implement: 실행하다 (이미 제시된 implementing은 현재진행형으로 '구현하다'로 사용되었으니 다른 의미의 '실행하다'로 사용합니다)

imply: 암시하다

impose: 부과하다

incline: ~할 마음이 생기게 하다

incorporate: 포함하다 (이미 제시된 incorporate와 중복. '포함하다'의 다른 뉘앙스)

incur: (손실을) 입다

induce: 유도하다

infer: 추론하다

initiate: 시작하다

innovate: 혁신하다

inspect: 검사하다

inspire: 영감을 주다

integrate: 통합하다

intend: 의도하다

interact: 상호작용하다

interfere: 간섭하다

interpret: 해석하다 (이미 제시된 interpret는 '해석하다/이해하다'로 사용되었으니 다른 뉘앙스의 '해석하다'로 사용합니다)

intervene: 개입하다

intimidate: 위협하다

involve: 관련시키다, 포함하다

justify: 정당화하다

launch: 시작하다, 발사하다

legitimize: 정당화하다

levy: 부과하다 (이미 제시된 levy는 '추가 부담금/세금' 명사형으로 사용되었으니 동사형으로 사용합니다)

leverage: 활용하다

maintain: 유지하다

manage: 관리하다, 간신히 해내다

manifest: 나타내다 (이미 제시된 manifest는 '명백한' 형용사형으로 사용되었으니 동사형으로 사용합니다)

manipulate: 조종하다

mediate: 중재하다

merge: 합병하다

mitigate: 완화하다

monitor: 감시하다

motivate: 동기를 부여하다

navigate: 길을 찾다, 잘 처리하다

necessitate: ~을 필요하게 만들다

negate: 무효화하다

negotiate: 협상하다

normalize: 정상화하다

notify: 통지하다

oblige: 의무를 지우다

observe: 관찰하다, 준수하다

obtain: 얻다

occupy: 차지하다

offend: 불쾌하게 하다, 위반하다

omit: 생략하다 (이미 제시된 omit과 중복. '생략하다'의 다른 뉘앙스)

operate: 작동하다, 운영하다

optimize: 최적화하다

originate: 유래하다

overcome: 극복하다

overlook: 간과하다

oversee: 감독하다 (이미 제시된 oversee와 중복. '감독하다'의 다른 뉘앙스)

perceive: 인지하다

perform: 수행하다

persuade: 설득하다

pertain: 관련되다

phase out: 단계적으로 중단하다




preside: 주재하다

prevail: 만연하다, 우세하다

prioritize: 우선순위를 매기다

process: 처리하다

prohibit: 금지하다

promote: 촉진하다, 승진시키다

propose: 제안하다

prosper: 번영하다 (이미 제시된 prosper와 중복. '번영하다'의 다른 뉘앙스)

prove: 증명하다

provide: 제공하다

pursue: 추구하다

qualify: 자격을 주다

quantify: 수량화하다

reduce: 줄이다

refer: 참조하다, 언급하다

refine: 정제하다

reflect: 반영하다

reform: 개혁하다

regulate: 규제하다

reinforce: 강화하다

reject: 거부하다

relate: 관련시키다

release: 풀어주다, 공개하다


reproduce: 복제하다, 번식하다



형용사 (Adjectives)
accurate: 정확한

adequate: 충분한

adjacent: 인접한

affective: 감정적인

affirmative: 긍정적인

ambiguous: 모호한

ample: 충분한, 풍부한

analytical: 분석적인 (이미 제시된 analytical과 중복. '분석적인'의 다른 뉘앙스)

apt: 적절한

arbitrary: 임의적인


chief: 주요한

chronic: 만성적인

clear: 명확한

cohesive: 응집력 있는



credible: 신뢰할 수 있는

crucial: 결정적인


dependent: 의존적인

desirable: 바람직한

desperate: 절박한

destitute: 궁핍한

detailed: 상세한

distinct: 뚜렷한

distinguished: 저명한

diverse: 다양한

dominant: 지배적인

dubious: 의심스러운

durable: 내구성 있는

exclusive: 독점적인

exhaustive: 철저한

expedient: 편리한, 적절한

explicit: 명시적인

factual: 사실적인

fair: 공정한, 상당한

false: 잘못된

familiar: 익숙한

feasible: 실행 가능한

feeble: 연약한

fierce: 맹렬한

firm: 단단한, 확고한

flexible: 유연한


grand: 웅장한

grave: 심각한, 무덤

gross: 총체적인, 역겨운


heavy: 무거운

hidden: 숨겨진

hollow: 속이 빈

honest: 정직한

humble: 겸손한

ideal: 이상적인

ignorant: 무지한

immense: 거대한

imminent: 임박한

impartial: 공정한

impeccable: 흠 잡을 데 없는

implicit: 암묵적인

impressive: 인상적인

inadequate: 부적절한



integral: 필수적인

intense: 강렬한

interim: 임시의

internal: 내부의

intricate: 복잡한

intuitive: 직관적인

irrelevant: 관련 없는

부사 (Adverbs)



fairly: 상당히, 공정하게

frankly: 솔직히

frequently: 자주

furthermore: 게다가

gradually: 점진적으로

hardly: 거의 ~않다

hence: 그러므로

ideally: 이상적으로

immediately: 즉시

incidentally: 우연히, 그런데

indeed: 정말로

indirectly: 간접적으로

individually: 개별적으로

inevitably: 불가피하게

initially: 처음에

particularly: 특히

perhaps: 아마도

personally: 개인적으로


relatively: 상대적으로

reportedly: 보도에 따르면

roughly: 대략




unevenly: 고르지 않게

uniformly: 균일하게 (이미 제시된 uniformly과 중복. '균일하게'의 다른 뉘앙스)



unlikely: ~할 것 같지 않은

unquestionably: 의심할 여지 없이

urgently: 긴급하게



verbally: 구두로


Let alone ~ – ~은 말할 것도 없이
 e.g., He can’t even cook, let alone bake a cake.


For what it’s worth – 별거 아니지만, 참고로




walk on eggshells – 눈치를 보다, 조심하다
you name it – 뭐든지 (다 있다)