

duck out - 슬그머니 빠져나가다
ease off - 완화되다
edge out - 간신히 이기다
end up - 결국 ~하게 되다
face up to - 직시하다
fall for - 속다, 사랑에 빠지다
fend off - 막아내다

fizzle out - 흐지부지 끝나다
flare up - 확 타오르다, 악화되다
freak out - 기겁하다


give in - 굴복하다
go about - 처리하다


hang out - 어울리다
head off - 막다
hear out - 끝까지 듣다
hit it off - 죽이 잘 맞다
hold off - 미루다
hold over - 연기하다
hunker down - 단단히 준비하다
keep at - 포기하지 않고 계속하다

kick around - 논의하다
knock off - 그만두다
lash out - 마구 화를 내다
lay into - 거칠게 비난하다
lead up to - 결국 ~에 이르다
let on - 누설하다
let up - 약해지다
lighten up - 기분을 풀다
live down - 잊히게 하다
lock in - 확정하다
log off - 로그아웃하다
