
Count on - 의지하다
Draw up - (계획) 세우다
Drop off - 내려주다
Fall behind - 뒤처지다
Run out of - 다 떨어지다
Brush up (on) - 복습하다
Catch up (with) - 따라잡다
Come down with - (병에) 걸리다
Cut down on - 줄이다
Get by - 근근이 살아가다
Give out - 배포하다 / 고장 나다
Hand in - 제출하다
Hold back - 억제하다
Keep on - 계속하다
Lay off - 해고하다
Make out - 이해하다/(로맨틱하게)잘 어울리다
Mix up - 혼동하다
Pass out - 기절하다/나눠주다
Pay back - 갚다 / 복수하다
Point out - 지적하다
Pull off - 성공하다
Rip off - 바가지 쓰다
Rule out - 배제하다
Run over - (차로) 치다 / 넘어가다
Settle down - 정착하다
Stand out - 두드러지다
Step down - 사임하다
Stick to - 충실하다
Take up - (취미) 시작하다
Think over - 신중히 생각하다
Try out - 시험해 보다
Use up - 다 써버리다
Watch out - 조심하다
Wear out - 닳다 / 지치게 하다
Wind up - 결국 ~하게 되다
