


환경/기후

climate change - 기후변화
global warming - 지구온난화
emissions - 배출량
carbon footprint - 탄소발자국
greenhouse gases - 온실가스
renewable energy - 재생에너지

ozone depletion - 오존층 파괴
fossil fuels - 화석연료
protocol - 의정서

보건/의학
antibody - 항체
mutation - 돌연변이
incubation period - 잠복기
inequality - 불평등
discrimination - 차별
inclusion - 포용
gentrification - 젠트리피케이션
underprivileged - 혜택받지 못한
demographic - 인구통계학적인


경제 용어 추가


monetary policy - 통화정책
quantitative easing - 양적완화
interest rate - 이자율
depreciation - 감가상각
appreciation - 가치상승
devaluation - 평가절하
deficit - 적자
surplus - 흑자
trade balance - 무역수지


중요 표현

in light of - ~에 비추어
with regard to - ~에 관하여
in response to - ~에 대응하여
in the wake of - ~의 여파로
on the heels of - ~에 뒤이어
in the midst of - ~의 한가운데서
against the backdrop of - ~을 배경으로
in conjunction with - ~와 함께
notwithstanding - ~에도 불구하고
nevertheless - 그럼에도 불구하고
furthermore - 더욱이
consequently - 결과적으로
