account for: 고려하다/설명하다  
aggregate into: ~로 집계하다  
appear before: ~앞에 출두하다  
back out: (약속 등에서) 포기하다  
balance out: 균형을 맞추다  
barrels on: 멈추지 않고 돌진하다
be all about: ~을 중시하다 / ~에 전념하다  
be done with someone: ~와 끝을 보다  
behind bars: 감옥에서  
bleed energy: 속도 줄이다  
blend in: 녹아들다  
blew off : 바람에 날려 벗어나다  
break apart : 분해하다  
break away: 분리되다  
break down : 분해하다  
break up: 해산시키다   
breakdown: 실패/결렬/와해  
bring in : 끌어들이다  
bring on: 초래하다  
bring up: 제기하다/언급하다/기르다
brings to light 대상: (대상을) 드러낸다  
brush up (on): (지식을) 복습하다  
bump into: 우연히 만나다  
by means of: ~를 써서  
call back: 다시 전화하다  
call for : (무언가를)예상하다/예보하다/요청하다/필요로 하다  
call off: 취소하다  
call on: 촉구하다   
care to + 동사원형: ~해 보시겠어요?  
carry on: 계속하다  
carry out : 실천하다  
cash in: 현금화하다  
catch up: 따라잡다  
catch up (with): 따라잡다  
chuck: 던지다/그만두다  
closed down: 폐쇄하다
come across: 우연히 만나다  
come apart: 흩어지다  
come down with: (병에) 걸리다  
come up with: 생각해내다  
coming out of: ~을 벗어나다  
count on: 의지하다  
covers more distance: 더 많은 거리를 이동하다
crack down on: ~을 탄압하다/단속하다  
cut down on: 줄이다  
cut off: 차단하다  
cut ties with: ~와 관계를 끊다  
date back: ~이래 계속 존재하고 있다  
derive from: ~에서 유래하다  
die down: 가라앉다  
die of: ~로 죽다  
die out: 사라지다/소멸하다  
distribute across: ~에 걸쳐 분산하다  
do away with: 폐지하다  
do time: 감옥살이를 하다  
do up: 장식하다  
doze off: 깜빡 잠들다  
drag on: 질질 끌다  
draw out: 길게 끌다  
draw up: (계획 등을) 세우다  
dress down: 호되게 꾸짖다  
driven off: 격퇴하다
drop in on: 불쑥 방문하다  
drop off: 전달하다/내려주다  
dug around: 파헤쳤다/조사했다
ease off: 완화되다  
edge out: 간신히 이기다  
end up: 결국 ~하게 되다  
erring on the side of caution: 안전한 쪽을 택하다  
expand on: 자세히 설명하다  
face up to: 직시하다  
fall apart: 부서지다/(관계) 무너지다  
fall behind: 뒤처지다  
fall for: ~에 속다  
fan out: 부채꼴로 퍼지다  
fend off: 막아내다  
fill in (for): ~를 대신하다  
fizzle out: 흐지부지 끝나다  
flare up: 확 타오르다/악화되다  
follow up on: ~를 추적 조사하다  
freak out: 기겁하다  
gear towards: ~에 맞추다  
get ahead: 성공하다  
get all fancy: 과시하려 들다  
get along: (사람들과) 어울리다  
get at: 의미하다  
get away with: (처벌 받지 않고) 해내다  
get by: 근근이 살아가다  
get down to: 이제 집중해서 시작하다  
get on with: ~와 잘 지내다  
get pegged: ~로 간주되다  
get roped into: 억지로 끌려들어가다  
get with: ~와 함께하다  
give a crap (about something): 신경 쓰다 (구어체 표현)  
give away: 포기하다/거저 주다  
give chase: 추격하다  
give in: 굴복하다  
give off s.t vibes: ~한 느낌을 주다  
give out: 배분하다/할당하다  
go about: 처리하다  
go after: ~를 추적하다  
go ahead: 진행되다  
go back on: (약속을) 어기다  
go by: 지나가다/~라는 이름으로 불리다  
go down: 기록하다  
go off: 폭발하다/맛이 가다  
go off of: 의지하다  
go on: (어떤 일이) 일어나다 / 계속 진행되다  
go out of one's way: 특별히 노력하다  
go over: 검토하다/반복 설명하다/넘어가다  
go through: 경험하다/검토하다  
go under: 파산하다  
go up against: ~와 맞서다  
grind to a halt: 멈추다  
grow by: ~만큼 커지다/성장하다  
grow on: 점점 좋아지다  
hang around: 어슬렁거리다  
hang in: 버티다  
have nothing to do with: ~와 아무 관련이 없다  
have on: ~에 대한 약점을 잡고 있다  
have regained control: 다시 장악하다  
have to do with: ~와 관련있다  
have yet to + 동사원형: 아직 ~하지 않았다  
head in: 들어가다  
help s.b out: ~를 도와주다  
hold back: 억제하다  
hold up: 잠시 멈추다  
hunker down: 단단히 준비하다  
in turn: 차례로/결과적으로 
jump on it: 즉시 달려들다  
keep in place: 그대로 유지하다  
keep s.t apart: 둘을 분리해서 구분하다  
keep up (with): 따라가다  
kick around: 논의하다  
kickoff: (경기가) 시작되다  
knock off: 그만두다  
lash out: 마구 화를 내다  
lay into: 거칠게 비난하다  
leave one's mark: 자신의 흔적을 남기다  
left behind: 버려두다  
let on: 내색하다/누설하다  
let up: 약해지다  
lies in: (~의 핵심은) ~에 있다  
lighten up: 기분을 풀다  
live down: (과거를) 잊히게 하다  
Live off: ~로 생활하다  
live up to: 기대에 부응하다  
lock down: 잠그다/봉쇄하다  
lock in: 확정하다  
look up: 찾아보다/존경하다  
make for: 향하다  
make fun of: 조롱하다  
make out: 해내다/알아보다  
make up: ~을 구성하다  
make up for: 보상하다  
maybe I should / I wonder if I should: ~해볼까나  
mess up: 망치다  
moved out of: 철수하다  
nestle: (아늑한 곳에) 눕다/앉다  
nod off: 꾸벅꾸벅 졸다  
on death row: 사형수 수감동에서  
on the fly: 즉석에서/실시간으로  
on the order of: 대략 ~정도의  
open up: 가능성을 열다  
opens up on: 맹렬히 사격하다 
out of + 감정/동기: ~때문에  
overcome: 압도당하다/극복하다  
page in: (컴퓨터 메모리로) 불러오다  
pace yourselves: 천천히 하다  
pass away: 죽다 (완곡 표현)  
pass into law: 법률로 제정되다  
pave the way: 길을 닦다/토대를 마련하다  
pay off: 성과를 내다 (빚을 갚다의 의미도 있음)  
pick up: 배우다  
pool in: (물이) 고이다  
pop up: 갑자기 나타나다  
powered through: (어려움을) 해내다  
pull A out of B: A를 B에서 철수시키다  
pull off: (힘든 일을) 해내다  
put an end: ~을 종식시키다  
put away: 제자리에 두다  
put in: 요청하다/전화 걸다  
put into practice: 실행에 옮기다  
put out (fires): 불을 끄다/진압하다  
put up: display/show/내보이다/저항하다  
put up with: 참다/견디다  
put upon: 도입하다 (impose와 유사한 의미로 쓰이는 경우)  
reach out: ~와 접촉하려고 하다  
reach out to: 연락하다/도움을 요청하다  
rise above: ~을 넘다  
rough someone up: 폭력을 쓰다  
round off: ~을 마무리짓다  
rule out: 배제하다  
run for: ~에 출마하다  
run for it: 도망치다  
run from A to B: A에서 B로 이어지다  
run into: 우연히 만나다  
run out of: ~이 다 떨어지다  
run over: (차로) 치다/넘어가다  
score hit after hit: 계속 명중시키다  
serve time: 복역하다  
set off: 촉발시키다  
set up: 설치하다/계획하다  
settle down: 자리를 잡다  
she brought the case: 그녀가 소송을 제기했다  
shift over: 이동하다  
sit ~ away: ~만큼 거리에 위치해 있다  
slams into: 강하게 충돌하다  
split up: 분할하다  
stand out: 두드러지다  
stand up for: ~를 변호하다  
start out on: ~을 시작하다  
step up: 나서다/강화하다  
stick out: 툭 튀어나오다  
stick to: ~에 충실하다  
striking back: 반격하다  
strike down: 폐지하다/(판결을) 뒤집다  
take as input: 입력으로 받는다  
take back: 회수하다/취소하다  
take care of (personally): 직접 처리하다  
take cover: 지형을 이용하여 숨다  
take effect: 시행되다  
take heart: 용기를 내어 ~하다  
take out: 밖으로 꺼내다  
take over: 물려받다  
take something up: ~을 시작하다  
take up: 시작하다/차지하다/받아들이다/계속하다  
tap into: 접속하다/도청하다  
tap out: 모스 부호 메시지를 보내다  
tear gas: 최루탄  
tear through: 파괴적으로 관통하다  
trade in: 교체하다  
try out: 시험해 보다  
turn up: 나타나다/(소리) 높이다  
turned away from: ~로부터 벗어나다  
ups and downs: 기복  
up to: ~의 권한,책임 하에 있다/~할 능력이 있다/~을 감당할 수 있다/(수량) ~까지  
went south: 상황이 나빠지다  
were sworn into: ~에 취임하다 
work around: 우회하다  
work back up: 다시 거꾸로 올라가다  
work on: ~에 대해 작업하다/노력하다  
work out: 운동하다/해결되다  
work through: 극복하다  
work up: (용기 등을) 키우다  
write for: ~에 기고하다  
zero in on: ~에 집중하다  
